50
20
22 26 26 26 26 26 22 22 22 22 22 22 22 22 22 26 26 26 26 26 26 26 26 26 26 26 26 26 26 26 26 26 26 26 26 26 26 26 26 26 26 26 26 26 26 26 26 26 22 22
22 4 0 0 0 0 28 26 22 22 22 22 22 22 22 4 0 0 0 0 0 0 0 0 0 0 0 0 0 0 0 0 0 0 0 0 0 0 0 0 0 0 0 0 0 0 0 3 22 22
22 4 0 0 0 0 0 0 28 26 26 26 26 26 5 21 21 21 2 0 0 0 0 0 1 21 2 0 0 0 0 0 0 0 0 0 0 0 0 0 0 0 0 0 0 0 0 0 29 22
5 21 21 21 21 2 0 0 0 0 0 0 0 0 28 26 26 5 21 21 21 21 21 21 21 5 24 25 0 0 0 0 0 0 0 0 0 0 0 0 0 0 0 0 0 0 0 0 30 22
22 22 22 22 22 4 0 0 0 0 0 0 0 0 0 0 0 28 26 26 26 26 26 26 26 27 0 0 0 0 0 23 24 24 25 0 0 0 0 23 24 24 25 0 1 21 21 21 6 22
22 22 22 22 22 4 1 21 21 21 2 0 0 0 0 0 0 0 0 0 0 0 0 0 0 0 0 0 0 0 0 0 0 0 0 0 0 0 0 0 0 0 0 0 0 28 26 26 22 22
22 22 22 26 27 0 3 22 22 22 4 0 23 25 0 0 0 0 0 0 0 0 0 0 0 0 0 23 25 0 0 0 0 0 0 0 23 25 0 0 0 0 0 0 0 0 0 3 22 22
22 22 27 0 0 0 0 28 26 27 0 0 0 0 0 0 0 0 0 23 25 0 0 0 23 25 0 0 0 0 23 24 25 0 0 0 0 0 0 0 0 0 0 0 0 0 0 3 22 22
22 22 4 0 1 21 2 0 0 0 0 0 0 0 0 23 25 0 0 0 0 0 0 0 0 0 0 0 0 0 0 0 0 0 0 23 25 0 0 0 0 0 0 0 0 0 0 3 22 22
22 5 21 21 21 22 4 0 0 0 0 0 0 0 0 0 0 0 0 0 0 0 0 0 0 0 0 0 0 0 0 0 0 0 0 0 0 0 0 0 0 0 0 0 0 0 0 3 22 22
22 26 26 26 26 27 0 0 0 0 0 0 23 25 0 0 0 0 0 0 0 0 0 0 0 0 0 0 0 0 0 0 0 0 0 0 0 1 21 21 21 2 0 0 0 0 0 3 22 22
22 4 0 0 0 0 0 0 0 0 0 0 0 0 0 0 1 21 2 0 0 1 21 2 0 0 0 0 0 0 0 0 0 23 24 25 0 0 28 26 27 0 23 25 0 0 0 3 22 22
22 4 0 0 0 0 1 21 21 21 2 0 0 0 0 0 0 28 21 21 21 21 27 0 0 0 0 0 0 0 0 0 0 0 0 0 0 0 0 0 0 0 0 0 0 0 0 3 22 22
22 4 0 0 0 0 3 22 22 22 4 0 23 25 0 0 0 0 0 0 0 0 0 0 0 0 0 0 0 0 0 23 25 0 0 0 23 25 0 0 0 0 0 0 23 25 0 3 22 22
22 4 0 0 1 21 2 28 26 27 0 0 0 0 0 0 0 0 0 0 0 0 0 0 0 0 0 0 0 0 0 0 0 0 0 0 0 0 0 0 0 0 0 0 0 0 0 3 22 22
5 21 21 21 21 22 4 0 0 0 0 0 0 0 0 0 23 24 25 0 0 1 21 2 0 0 1 21 2 0 0 0 0 0 0 0 0 0 0 0 1 21 2 0 0 1 21 21 22 22
22 26 26 26 26 27 0 0 0 0 0 0 0 0 0 0 0 0 0 0 0 3 5 21 21 21 21 22 4 0 0 0 0 0 0 0 0 0 0 0 3 22 21 21 21 21 6 22 22 22
22 4 0 0 0 0 0 0 0 0 0 0 23 25 0 0 0 0 0 0 0 3 22 26 26 26 26 27 0 1 21 2 1 21 21 21 2 1 21 2 0 28 26 26 26 26 22 22 22 22
22 4 0 0 1 21 2 0 0 1 21 2 0 0 0 0 0 0 0 0 0 3 22 4 0 0 0 0 1 21 22 4 3 22 22 22 4 3 22 21 2 0 0 0 0 3 22 22 22 22
22 4 0 0 3 5 21 21 21 21 6 4 0 0 0 0 0 0 0 0 0 3 22 21 21 21 21 21 21 22 22 4 0 28 26 27 0 3 22 22 21 21 21 21 21 21 22 22 22 22