20
8
22 22 4 0 0 0 0 0 0 0 0 0 0 0 0 0 0 3 22 22
22 22 4 0 0 0 0 0 0 0 0 0 0 0 0 0 0 3 22 22
22 22 4 0 0 0 0 0 0 0 0 0 0 0 0 0 0 3 22 22
22 22 4 0 0 0 0 0 0 0 0 0 0 0 0 0 0 3 22 22
22 22 4 0 0 0 0 0 0 0 0 0 0 0 0 0 0 3 22 22
22 22 4 11 0 0 0 0 0 0 0 0 0 0 0 0 0 0 29 22
22 22 4 0 0 0 0 0 0 0 0 0 0 0 0 0 0 0 30 22
22 5 21 21 21 21 21 21 21 21 21 21 21 21 21 21 21 21 6 22