20
10
22 4 0 0 0 0 0 0 0 0 0 0 0 0 0 0 0 3 22 22
29 0 0 0 0 0 0 0 0 0 0 0 0 0 0 0 0 3 22 22
30 0 0 0 0 0 0 0 0 0 0 0 0 0 0 0 0 3 22 22
22 21 31 0 0 23 24 25 0 0 23 25 0 0 0 0 0 3 22 22
22 22 10 0 0 0 0 0 0 0 0 0 0 0 23 25 0 3 22 22
22 26 27 0 0 0 0 0 0 0 0 0 0 0 0 0 0 3 22 22
22 4 0 0 0 0 0 0 0 0 0 23 24 24 25 0 0 3 22 22
22 4 7 0 0 0 0 23 25 0 0 0 0 0 0 0 0 3 22 22
22 4 0 0 23 25 0 0 0 0 0 0 0 0 0 0 0 3 22 22
5 21 2 0 0 0 0 0 0 0 0 0 0 0 0 0 0 3 22 22