30
8
22 26 26 26 26 26 26 26 26 26 26 26 26 26 26 26 26 26 26 26 26 26 26 26 26 26 26 26 26 22
22 0 0 0 0 0 0 0 0 0 0 0 0 0 0 0 0 0 0 0 0 0 0 0 0 0 0 0 3 22
22 0 0 0 0 1 21 2 0 0 0 0 0 0 0 0 0 0 0 0 0 0 0 0 0 0 0 0 0 29
22 21 21 21 21 21 22 25 0 0 0 0 0 0 0 0 8 0 0 0 0 0 0 8 0 0 0 0 0 30
22 22 22 22 22 22 27 0 0 0 0 0 23 25 0 0 0 0 0 23 25 0 0 0 0 0 23 21 21 6
22 26 26 26 26 27 0 0 0 23 25 0 0 0 0 0 0 0 0 0 0 0 0 0 0 0 0 28 26 22
22 4 0 0 0 0 0 0 0 0 0 0 0 0 0 0 0 0 0 0 0 0 0 0 0 0 0 0 3 22
5 21 21 21 21 21 21 21 21 2 0 0 0 0 0 0 0 0 0 0 0 0 0 0 0 0 0 0 3 22