21
30
22 22 22 22 22 22 22 22 22 22 22 22 22 22 22 22 22 22 22 22 22
22 26 26 26 26 26 26 26 26 26 22 26 26 26 26 26 26 26 26 26 22
22 4 0 0 0 0 0 0 0 3 22 4 0 0 0 0 0 0 0 3 22
29 0 0 0 0 0 0 0 0 3 22 4 0 0 0 0 0 0 0 3 22
30 0 0 0 0 0 0 0 0 3 22 4 0 0 0 0 0 0 0 3 22
22 25 0 0 0 23 25 0 0 3 22 21 21 21 21 21 2 1 21 21 22
22 4 0 0 0 0 0 0 0 3 22 4 0 0 0 0 0 0 0 3 22
22 21 2 0 0 0 0 0 0 3 22 4 0 0 0 0 0 0 23 24 22
22 26 4 0 0 0 0 0 0 3 22 4 0 0 0 0 0 0 0 3 22
22 4 0 0 0 23 25 0 0 3 22 4 0 0 0 0 0 0 23 24 22
22 4 0 0 0 0 0 0 0 23 22 25 0 0 0 0 0 0 0 3 22
22 4 0 0 0 0 0 0 0 3 22 4 0 0 0 0 0 0 0 3 22
22 4 0 0 0 0 0 0 0 23 22 24 25 0 0 0 0 0 0 3 22
22 4 0 0 0 0 0 0 0 3 22 4 0 0 0 0 0 0 0 23 22
22 4 0 0 0 0 0 0 0 23 22 4 0 0 0 0 0 0 0 3 22
22 4 0 0 0 0 0 0 0 3 22 4 0 0 0 0 0 0 0 23 22
22 4 0 0 23 24 25 0 0 3 22 4 0 0 0 0 0 0 0 3 22
22 4 0 0 0 0 0 0 0 3 22 4 0 0 0 0 0 0 0 23 22
22 25 0 0 0 0 0 0 0 3 22 4 0 0 0 0 0 0 0 3 22
22 4 0 0 0 0 0 0 0 3 22 4 0 0 0 0 0 0 23 24 22
22 25 0 0 0 0 0 0 0 3 22 4 0 0 0 0 0 0 0 3 22
22 4 0 0 0 0 0 0 0 3 22 4 23 25 0 0 0 0 0 3 22
22 25 0 0 0 0 0 0 0 3 22 4 0 0 0 0 0 0 0 3 22
22 4 0 0 0 0 0 0 0 3 22 25 0 0 0 0 0 0 0 3 22
22 24 25 0 0 0 0 0 0 3 22 4 0 0 0 0 0 0 0 3 22
22 4 0 0 0 0 0 0 0 3 26 24 25 0 0 0 0 0 0 3 22
22 4 0 23 25 0 0 0 0 0 0 0 0 0 0 0 0 0 0 23 22
22 4 0 0 0 0 0 0 0 0 0 0 0 0 0 0 0 0 0 3 22
22 21 21 21 21 21 21 21 21 21 21 21 21 21 21 21 21 21 21 21 22
22 22 22 22 22 22 22 22 22 22 22 22 22 22 22 22 22 22 22 22 22