20
19
22 4 0 0 0 0 0 0 0 0 0 0 0 0 0 0 0 3 22 22
29 0 0 0 0 0 0 0 0 0 0 0 0 0 0 0 0 3 22 22
30 0 0 0 0 0 0 0 0 0 0 0 0 0 0 0 0 3 22 22
5 31 0 23 24 24 25 0 23 25 0 0 0 0 0 0 0 3 22 22
22 27 0 0 0 0 0 0 0 0 0 0 0 0 0 0 0 3 22 22
22 4 0 0 0 0 0 0 0 0 1 21 2 0 0 0 0 3 22 22
22 21 21 21 21 21 21 21 21 21 21 22 31 0 0 0 0 3 22 22
22 26 26 26 26 26 26 26 26 26 26 26 27 0 0 23 25 3 22 22
22 4 0 0 0 0 0 0 0 0 0 0 0 0 0 0 0 3 22 22
22 4 0 0 0 0 0 0 0 0 0 23 24 24 25 0 0 3 22 22
22 4 0 0 0 0 0 0 0 0 0 0 0 0 0 1 21 2 22 22
22 4 0 0 0 0 23 24 25 0 0 0 0 0 0 0 0 3 22 22
22 4 0 0 0 0 0 0 0 0 0 0 0 0 0 0 1 21 22 22
22 4 23 25 0 0 0 0 0 0 0 0 0 0 0 0 0 28 22 22
22 4 0 0 0 0 0 0 0 0 0 0 0 0 23 25 0 3 22 22
22 31 0 0 1 21 2 0 0 0 0 0 0 0 0 0 0 3 22 22
22 27 0 1 21 22 21 21 21 21 21 21 21 21 21 21 21 21 6 22
22 0 0 0 12 0 0 0 0 0 0 0 0 0 0 0 0 3 22 22
5 21 21 21 21 21 21 21 21 21 21 21 21 21 21 21 21 21 6 22